####  #### ####
# #   #       #
### # ##### #  
#   # ####### #
# ###         #
#     #####   #
### #         #
    # ######  #
#####     ##  #
##### ######  #
          #   #
  #########  ##
             ##
    ##       ##
 ## #### ## ###