######
#S...#
##.#.#
#..#.#
#.##.#
####X#